### General level information ###
AreaCount=1
MarioStart=None,17,2

### Area 1: main ###
Area=main
Flags=
20 195
gray_mountains
ground_blue
3

# Blocks and Coins
62
block 1 10,165 BLOCK_ROCK
block 2 10,166 BLOCK_ROCK
block 3 17,134 BLOCK_YELLOW_COIN
block 4 17,133 BLOCK_YELLOW_COIN
block 5 17,132 BLOCK_YELLOW_COIN
block 6 11,165 BLOCK_ROCK
block 7 8,29 BLOCK_YELLOW_COIN
block 8 8,30 BLOCK_YELLOW_COIN
block 9 8,31 BLOCK_YELLOW_COIN
block 10 11,166 BLOCK_ROCK
block 11 17,161 BLOCK_ROCK
block 12 14,66 BLOCK_QUESTION fireflower,visible
block 13 17,163 BLOCK_ROCK
block 14 17,162 BLOCK_ROCK
block 15 17,165 BLOCK_ROCK
block 16 17,164 BLOCK_ROCK
block 17 17,166 BLOCK_ROCK
block 18 16,35 BLOCK_YELLOW_COIN
block 19 16,161 BLOCK_ROCK
block 20 16,162 BLOCK_ROCK
block 21 16,163 BLOCK_ROCK
block 22 11,143 BLOCK_YELLOW_COIN
block 23 16,164 BLOCK_ROCK
block 24 11,142 BLOCK_YELLOW_COIN
block 25 16,165 BLOCK_ROCK
block 26 16,166 BLOCK_ROCK
block 27 14,164 BLOCK_ROCK
block 28 14,165 BLOCK_ROCK
block 29 14,166 BLOCK_ROCK
block 30 14,161 BLOCK_ROCK
block 31 14,162 BLOCK_ROCK
block 32 14,163 BLOCK_ROCK
block 33 10,97 BLOCK_YELLOW_COIN
block 34 10,96 BLOCK_YELLOW_COIN
block 35 15,165 BLOCK_ROCK
block 36 15,164 BLOCK_ROCK
block 37 15,166 BLOCK_ROCK
block 38 15,161 BLOCK_ROCK
block 39 15,163 BLOCK_ROCK
block 40 15,162 BLOCK_ROCK
block 41 9,68 BLOCK_YELLOW_COIN
block 42 9,69 BLOCK_YELLOW_COIN
block 43 7,44 BLOCK_YELLOW_COIN
block 44 9,70 BLOCK_YELLOW_COIN
block 45 7,43 BLOCK_YELLOW_COIN
block 46 12,166 BLOCK_ROCK
block 47 12,164 BLOCK_ROCK
block 48 12,165 BLOCK_ROCK
block 49 12,163 BLOCK_ROCK
block 50 10,70 BLOCK_YELLOW_COIN
block 51 10,69 BLOCK_YELLOW_COIN
block 52 10,68 BLOCK_YELLOW_COIN
block 53 9,113 BLOCK_YELLOW_COIN
block 54 9,112 BLOCK_YELLOW_COIN
block 55 13,166 BLOCK_ROCK
block 56 9,108 BLOCK_YELLOW_COIN
block 57 13,165 BLOCK_ROCK
block 58 13,164 BLOCK_ROCK
block 59 13,163 BLOCK_ROCK
block 60 9,107 BLOCK_YELLOW_COIN
block 61 12,56 BLOCK_YELLOW_COIN
block 62 12,57 BLOCK_YELLOW_COIN

# Enemies
8
8,28 koopatroopa red
9,47 goomba
9,50 goomba
11,84 flying_koopatroopa red
11,92 goomba
12,122 koopatroopa red
10,133 flying_koopatroopa red
17,158 koopatroopa red

# Warps
0

# Other
1
17,173 goal

0 0 0 0 0 0 0 0 0 0 0 0 0 0 0 0 0 0 0 0 0 0 0 0 0 0 0 0 0 0 0 0 0 0 0 0 0 0 0 0 0 0 0 0 0 0 0 0 0 0 0 0 0 0 0 0 0 0 0 0 0 0 0 0 0 0 0 0 0 0 0 0 0 0 0 0 0 0 0 0 0 0 0 0 0 0 0 0 0 0 0 0 0 0 0 0 0 0 0 0 0 0 0 0 0 0 0 0 0 0 0 0 0 0 0 0 0 0 0 0 0 0 0 0 0 0 0 0 0 0 0 0 0 0 0 0 0 0 0 0 0 0 0 0 0 0 0 0 0 0 0 0 0 0 0 0 0 0 0 0 0 0 0 0 0 0 0 0 0 0 0 0 0 0 0 0 0 0 0 0 0 0 0 0 0 0 0 0 0 0 0 0 0 0 0
0 0 0 0 0 0 0 0 0 0 0 0 0 0 0 0 0 0 0 0 0 0 0 0 0 0 0 0 0 0 0 0 0 0 0 0 0 0 0 0 0 0 0 0 0 0 0 0 0 0 0 0 0 0 0 0 0 0 0 0 0 0 0 0 0 0 0 0 0 0 0 0 0 0 0 0 0 0 0 0 0 0 0 0 0 0 0 0 0 0 0 0 0 0 0 0 0 0 0 0 0 0 0 0 0 0 0 0 0 0 0 0 0 0 0 0 0 0 0 0 0 0 0 0 0 0 0 0 0 0 0 0 0 0 0 0 0 0 0 0 0 0 0 0 0 0 0 0 0 0 0 0 0 0 0 0 0 0 0 0 0 0 0 0 0 0 0 0 0 0 0 0 0 0 0 0 0 0 0 0 0 0 0 0 0 0 0 0 0 0 0 0 0 0 0
0 0 0 0 0 0 0 0 0 0 0 0 0 0 0 0 0 0 0 0 0 0 0 0 0 0 0 0 0 0 0 0 0 0 0 0 0 0 0 0 0 0 0 0 0 0 0 0 0 0 0 0 0 0 0 0 0 0 0 0 0 0 0 0 0 0 0 0 0 0 0 0 0 0 0 0 0 0 0 0 0 0 0 0 0 0 0 0 0 0 0 0 0 0 0 0 0 0 0 0 0 0 0 0 0 0 0 0 0 0 0 0 0 0 0 0 0 0 0 0 0 0 0 0 0 0 0 0 0 0 0 0 0 0 0 0 0 0 0 0 0 0 0 0 0 0 0 0 0 0 0 0 0 0 0 0 0 0 0 0 0 0 0 0 0 0 0 0 0 0 0 0 0 0 0 0 0 0 0 0 0 0 0 0 0 0 0 0 0 0 0 0 0 0 0
0 0 0 0 0 0 0 0 0 0 0 0 0 0 0 0 0 0 0 0 0 0 0 0 0 0 0 0 0 0 0 0 0 0 0 0 0 0 0 0 0 0 0 0 0 0 0 0 0 0 0 0 0 0 0 0 0 0 0 0 0 0 0 0 0 0 0 0 0 0 0 0 0 0 0 0 0 0 0 0 0 0 0 0 0 0 0 0 0 0 0 0 0 0 0 0 0 0 0 0 0 0 0 0 0 0 0 0 0 0 0 0 0 0 0 0 0 0 0 0 0 0 0 0 0 0 0 0 0 0 0 0 0 0 0 0 0 0 0 0 0 0 0 0 0 0 0 0 0 0 0 0 0 0 0 0 0 0 0 0 0 0 0 0 0 0 0 0 0 0 0 0 0 0 0 0 0 0 0 0 0 0 0 0 0 0 0 0 0 0 0 0 0 0 0
0 0 0 0 0 0 0 0 0 0 0 0 0 0 0 0 0 0 0 0 0 0 0 0 0 0 0 0 0 0 0 0 0 0 0 0 0 0 0 0 0 0 0 0 0 0 0 0 0 0 0 0 0 0 0 0 0 0 0 0 0 0 0 0 0 0 0 0 0 0 0 0 0 0 0 0 0 0 0 0 0 0 0 0 0 0 0 0 0 0 0 0 0 0 0 0 0 0 0 0 0 0 0 0 0 0 0 0 0 0 0 0 0 0 0 0 0 0 0 0 0 0 0 0 0 0 0 0 0 0 0 0 0 0 0 0 0 0 0 0 0 0 0 0 0 0 0 0 0 0 0 0 0 0 0 0 0 0 0 0 0 0 0 0 0 0 0 0 0 0 0 0 0 0 0 0 0 0 0 0 0 0 0 0 0 0 0 0 0 0 0 0 0 0 0
0 0 0 0 0 0 0 0 0 0 0 0 0 0 0 0 0 0 0 0 0 0 0 0 0 0 0 0 0 0 0 0 0 0 0 0 0 0 0 0 0 0 0 0 0 0 0 0 0 0 0 0 0 0 0 0 0 0 0 0 0 0 0 0 0 0 0 0 0 0 0 0 0 0 0 0 0 0 0 0 0 0 0 0 0 0 0 0 0 0 0 0 0 0 0 0 0 0 0 0 0 0 0 0 0 0 0 0 0 0 0 0 0 0 0 0 0 0 0 0 0 0 0 0 0 0 0 0 0 0 0 0 0 0 0 0 0 0 0 0 0 0 0 0 0 0 0 0 0 0 0 0 0 0 0 0 0 0 0 0 0 0 0 0 0 0 0 0 0 0 0 0 0 0 0 0 0 0 0 0 0 0 0 0 0 0 0 0 0 0 0 0 0 0 0
0 0 0 0 0 0 0 0 0 0 0 0 0 0 0 0 0 0 0 0 0 0 0 0 0 0 0 0 0 0 0 0 0 0 0 0 0 0 0 0 0 0 0 0 0 0 0 0 0 0 0 0 0 0 0 0 0 0 0 0 0 0 0 0 0 0 0 0 0 0 0 0 0 0 0 0 0 0 0 0 0 0 0 0 0 0 0 0 0 0 0 0 0 0 0 0 0 0 0 0 0 0 0 0 0 0 0 0 0 0 0 0 0 0 0 0 0 0 0 0 0 0 0 0 0 0 0 0 0 0 0 0 0 0 0 0 0 0 0 0 0 0 0 0 0 0 0 0 0 0 0 0 0 0 0 0 0 0 0 0 0 0 0 0 0 0 0 0 0 0 0 0 0 0 0 0 0 0 0 0 0 0 0 0 0 0 0 0 0 0 0 0 0 0 0
0 0 0 0 0 0 0 0 0 0 0 0 0 0 0 0 0 0 0 0 0 0 0 0 0 0 0 0 0 0 0 0 0 0 0 0 0 0 0 0 0 0 0 0 0 0 0 0 0 0 0 0 0 0 0 0 0 0 0 0 0 0 0 0 0 0 0 0 0 0 0 0 0 0 0 0 0 0 0 0 0 0 0 0 0 0 0 0 0 0 0 0 0 0 0 0 0 0 0 0 0 0 0 0 0 0 0 0 0 0 0 0 0 0 0 0 0 0 0 0 0 0 0 0 0 0 0 0 0 0 0 0 0 0 0 0 0 0 0 0 0 0 0 0 0 0 0 0 0 0 0 0 0 0 0 0 0 0 0 0 0 0 0 0 0 0 0 0 0 0 0 0 0 0 0 0 0 0 0 0 0 0 0 0 0 0 0 0 0 0 0 0 0 0 0
0 0 0 0 0 0 0 0 0 0 0 0 0 0 0 0 0 0 0 0 0 0 0 0 0 0 0 0 0 0 0 0 0 0 0 0 0 0 0 0 0 0 0 0 0 0 0 0 0 0 0 0 0 0 0 0 0 0 0 0 0 0 0 0 0 0 0 0 0 0 0 0 0 0 0 0 0 0 0 0 0 0 0 0 0 0 0 0 0 0 0 0 0 0 0 0 0 0 0 0 0 0 0 0 0 0 0 0 0 0 0 0 0 0 0 0 0 0 0 0 0 0 0 0 0 0 0 0 0 0 0 0 0 0 0 0 0 0 0 0 0 0 0 0 0 0 0 0 0 0 0 0 0 0 0 0 0 0 0 0 0 0 0 0 0 0 0 0 0 0 0 0 0 0 0 0 0 0 0 0 0 0 0 0 0 0 0 0 0 0 0 0 0 0 0
0 0 0 0 0 0 0 0 0 0 0 0 0 0 0 0 0 0 0 0 0 0 0 0 0 0 0 0 1024 512 512 1280 0 0 0 0 0 0 0 0 0 0 0 0 0 0 0 0 0 0 0 0 0 0 0 0 0 0 0 0 0 0 0 0 0 0 0 0 0 0 0 0 0 0 0 0 0 0 0 0 0 0 0 0 0 0 0 0 0 0 0 0 0 0 0 0 0 0 0 0 0 0 0 0 0 0 0 0 0 0 0 0 0 0 0 0 0 0 0 0 0 0 0 0 0 0 0 0 0 0 0 0 0 0 0 0 0 0 0 0 0 0 0 0 0 0 0 0 0 0 0 0 0 0 0 0 0 0 0 0 0 0 0 0 0 0 0 0 0 0 0 0 0 0 0 0 0 0 0 0 0 0 0 0 0 0 0 0 0 0 0 0 0 0 0
0 0 0 0 0 0 0 0 0 0 0 0 0 0 0 0 0 0 0 0 0 0 0 0 0 0 0 0 4864 4352 4352 5120 0 0 0 0 0 0 0 0 0 0 0 0 0 1024 512 512 512 512 512 1280 0 0 0 0 0 0 0 0 0 0 0 0 0 0 0 0 0 0 0 0 0 0 0 0 0 0 0 0 0 0 0 0 0 0 0 0 0 0 0 0 0 0 0 0 0 0 0 0 0 0 0 0 0 0 0 0 0 0 0 0 0 0 0 0 0 0 0 0 0 0 0 0 0 0 0 0 0 0 0 0 0 0 0 0 0 0 0 0 0 0 0 0 0 0 0 0 0 0 0 0 0 0 0 0 0 0 0 0 0 0 0 0 0 0 0 0 0 0 0 0 0 0 0 0 0 0 0 0 0 0 0 0 0 0 0 0 0 0 0 0 0 0 0
0 0 0 0 0 0 0 0 0 0 0 0 0 0 0 0 0 0 0 0 0 0 0 0 0 0 0 0 4864 4352 4352 5120 0 0 0 0 0 0 0 0 0 0 0 0 0 4864 4352 4352 4352 4352 4352 5120 0 0 0 0 0 0 0 0 0 0 0 0 0 0 0 0 1024 512 1280 0 0 0 0 0 0 0 0 0 0 0 0 0 0 0 0 0 0 0 0 0 0 0 0 0 0 0 0 0 0 0 0 0 0 0 0 0 0 0 0 0 0 0 0 0 0 0 0 0 0 0 0 0 0 0 0 0 0 0 0 0 0 0 0 0 0 0 0 0 0 0 0 0 0 0 0 0 0 0 0 0 0 0 0 0 0 0 0 0 0 0 0 0 0 0 0 0 0 0 0 0 0 0 0 0 0 0 0 0 0 0 0 0 0 0 0 0 0 0 0 0 0 0 0
0 0 0 0 0 0 0 0 0 0 0 0 0 0 0 0 0 0 0 0 0 0 0 0 0 0 0 0 4864 4352 4352 5120 0 0 0 0 0 0 0 0 0 0 0 0 0 4864 4352 4352 4352 4352 4352 5120 0 0 0 0 0 0 0 0 0 0 0 0 0 0 0 0 4864 4352 5120 0 0 0 0 0 0 0 0 0 0 0 0 0 0 0 0 1024 512 512 512 512 1280 0 0 0 0 0 0 0 0 0 0 0 0 0 0 0 0 0 0 0 0 0 0 0 0 0 0 0 0 0 0 0 0 0 0 0 0 0 0 0 0 0 0 0 0 0 0 0 0 0 0 0 0 0 0 0 0 0 0 0 0 0 0 0 0 0 0 0 0 0 0 0 0 0 0 0 0 0 0 0 0 0 0 0 0 0 0 0 0 0 0 0 0 0 0 0 0 0 0 0 0 0 0
0 0 0 0 0 0 0 0 0 0 0 0 0 0 0 0 0 0 0 0 0 0 0 0 0 0 0 0 4864 4352 4352 5120 0 0 0 0 0 0 0 0 0 0 0 0 0 4864 4352 4352 4352 4352 4352 5120 0 0 0 0 0 0 0 0 0 0 0 0 0 0 0 0 4864 4352 5120 0 0 0 0 0 0 0 0 0 0 0 0 0 0 0 0 4864 4352 4352 4352 4352 5120 0 0 0 0 0 512 512 512 512 0 0 0 0 0 0 0 0 0 0 0 0 0 0 0 0 0 0 0 1024 512 512 512 512 512 512 1280 0 0 0 0 0 0 0 0 0 0 0 0 0 0 0 0 0 0 0 0 0 0 0 0 0 0 0 0 0 0 0 0 0 0 0 0 0 0 0 0 0 0 0 0 0 0 0 0 0 0 0 0 0 0 0 0 0 0 0 0 0 0 0 0 0 0
0 0 0 0 0 0 0 0 0 0 0 0 0 0 0 0 0 0 0 0 0 0 0 0 0 1024 512 512 512 512 512 512 1280 0 0 0 0 0 1024 512 512 512 1280 0 0 4864 4352 4352 4352 4352 4352 5120 0 0 0 0 0 0 0 0 0 0 0 0 0 0 0 0 4864 4352 5120 0 0 0 0 0 0 0 0 1024 512 1280 0 0 0 0 0 4864 4352 4352 4352 4352 5120 0 0 0 0 0 0 0 0 0 0 0 0 0 0 512 512 512 512 0 0 0 0 0 0 0 0 0 0 4864 4352 4352 4352 4352 4352 4352 5120 0 0 0 0 0 0 0 0 0 0 0 0 0 0 0 0 0 0 0 0 0 0 0 0 0 0 0 0 0 0 0 0 0 0 0 0 0 0 0 0 0 0 0 0 0 0 0 0 0 0 0 0 0 0 0 0 0 0 0 0 0 0 0 0 0 0
0 0 0 0 0 0 0 0 0 0 0 0 0 0 0 0 0 0 0 0 0 0 0 0 0 4864 4352 4352 4352 4352 4352 4352 5120 0 0 0 0 0 4864 4352 4352 4352 5120 0 0 4864 4352 4352 4352 4352 4352 5120 0 0 0 0 0 0 0 0 0 0 0 0 0 0 0 0 4864 4352 5120 0 0 0 0 0 0 0 0 4864 4352 5120 0 0 0 0 0 4864 4352 4352 4352 4352 5120 0 0 0 0 0 0 0 0 0 0 0 0 0 0 0 0 0 0 0 0 0 0 0 0 0 0 0 0 4864 4352 4352 4352 4352 4352 4352 5120 0 0 0 0 0 0 0 0 1024 512 512 1280 0 0 0 1024 512 512 1280 0 0 0 0 0 0 0 0 0 0 0 0 0 0 0 0 0 0 0 0 0 0 0 0 0 0 0 0 0 0 0 0 0 0 0 0 0 0 0 0 0 0 0 0 0 0 0
0 0 0 0 0 0 0 0 0 0 0 0 0 0 0 0 0 0 0 0 0 0 0 0 0 4864 4352 4352 4352 4352 4352 4352 5120 0 0 0 0 0 4864 4352 4352 4352 5120 0 0 4864 4352 4352 4352 4352 4352 5120 0 0 0 0 0 0 0 0 0 0 0 0 0 0 0 0 4864 4352 5120 0 0 0 0 0 0 0 0 4864 4352 5120 0 0 0 0 0 4864 4352 4352 4352 4352 5120 0 0 0 0 0 0 0 0 0 0 0 0 0 0 0 0 0 0 0 0 0 0 0 0 0 0 0 0 4864 4352 4352 4352 4352 4352 4352 5120 0 0 0 0 0 0 0 0 4864 4352 4352 5120 0 0 0 4864 4352 4352 5120 0 0 0 0 0 0 0 0 0 0 0 0 0 0 0 0 0 0 0 0 0 0 0 0 0 0 0 0 0 0 0 0 0 0 0 0 0 0 0 0 0 0 0 0 0 0 0
0 0 0 0 0 0 20736 20992 21248 21504 21760 22016 22272 0 0 0 0 0 0 1024 512 512 1280 0 0 4864 4352 4352 4352 4352 4352 4352 5120 0 1024 512 1280 0 4864 4352 4352 4352 5120 0 0 4864 4352 4352 4352 4352 4352 5120 0 0 0 0 0 0 0 0 0 0 0 0 0 0 0 0 4864 4352 5120 0 0 0 0 0 0 0 0 4864 4352 5120 0 0 0 0 0 4864 4352 4352 4352 4352 5120 0 0 0 0 0 0 0 0 0 0 0 0 0 0 0 0 0 0 0 0 0 1024 512 512 1280 0 0 0 4864 4352 4352 4352 4352 4352 4352 5120 0 0 0 0 0 0 0 0 4864 4352 4352 5120 0 0 0 4864 4352 4352 5120 0 0 0 0 0 0 0 0 0 0 0 0 0 0 0 0 0 0 0 0 0 0 0 0 0 0 0 0 0 0 0 0 0 0 0 0 0 0 0 0 0 0 0 0 0 0 0
512 512 512 512 512 512 512 512 512 512 512 512 512 512 512 768 0 0 0 4864 4352 4352 5120 0 0 4864 4352 4352 4352 4352 4352 4352 5120 0 4864 4352 5120 0 4864 4352 4352 4352 5120 0 0 4864 4352 4352 4352 4352 4352 5120 0 0 0 0 1024 512 512 1280 0 0 0 0 0 0 1024 512 512 512 1312000 0 1024 512 512 512 1280 0 0 4864 4352 5120 0 0 0 0 0 4864 4352 4352 4352 4352 5120 0 0 0 0 0 0 0 0 0 0 0 0 0 0 0 0 0 0 0 0 0 4864 4352 4352 5120 0 0 0 4864 4352 4352 4352 4352 4352 4352 5120 0 0 0 1024 512 1280 0 0 4864 4352 4352 5120 0 0 0 4864 4352 4352 5120 0 0 0 0 256 512 512 512 512 512 512 512 512 512 512 512 512 512 512 512 512 512 512 512 512 512 512 512 512 512 512 512 512 512 512 512 512 512 512 512 512 512 512 512 512 512 512
4352 4352 4352 4352 4352 4352 4352 4352 4352 4352 4352 4352 4352 4352 4352 4608 0 0 0 4864 4352 4352 5120 0 0 4864 4352 4352 4352 4352 4352 4352 5120 0 4864 4352 5120 0 4864 4352 4352 4352 5120 0 0 4864 4352 4352 4352 4352 4352 5120 0 0 0 0 4864 4352 4352 5120 0 0 0 0 0 0 4864 4352 4352 4352 5120 0 4864 4352 4352 4352 5120 0 0 4864 4352 5120 0 0 0 0 0 4864 4352 4352 4352 4352 5120 0 0 0 0 0 0 0 0 0 0 0 0 0 0 0 0 0 0 0 0 0 4864 4352 4352 5120 0 0 0 4864 4352 4352 4352 4352 4352 4352 5120 0 0 0 4864 4352 5120 0 0 4864 4352 4352 5120 0 0 0 4864 4352 4352 5120 0 0 0 0 4096 4352 4352 4352 4352 4352 4352 4352 4352 4352 4352 4352 4352 4352 4352 4352 4352 4352 4352 4352 4352 4352 4352 4352 4352 4352 4352 4352 4352 4352 4352 4352 4352 4352 4352 4352 4352 4352 4352 4352 4352 4352 4352
