### General level information ###
AreaCount=1
MarioStart=None,14,1

### Area 1: main ###
Area=main
Flags=
20 143
fortress
castle_gray
4

# Blocks and Coins
33
block 1 9,88 BLOCK_QUESTION coin1,hidden
block 2 15,113 BLOCK_SOLID_BROWN
block 3 9,85 BLOCK_QUESTION coin1,hidden
block 4 15,112 BLOCK_SOLID_BROWN
block 5 15,115 BLOCK_SOLID_BROWN
block 6 15,114 BLOCK_SOLID_BROWN
block 7 15,117 BLOCK_SOLID_BROWN
block 8 15,116 BLOCK_SOLID_BROWN
block 9 15,118 BLOCK_SOLID_BROWN
block 10 9,82 BLOCK_QUESTION coin1,hidden
block 11 15,104 BLOCK_SOLID_BROWN
block 12 15,105 BLOCK_SOLID_BROWN
block 13 15,106 BLOCK_SOLID_BROWN
block 14 11,43 BLOCK_ROCK
block 15 15,107 BLOCK_SOLID_BROWN
block 16 15,108 BLOCK_SOLID_BROWN
block 17 15,109 BLOCK_SOLID_BROWN
block 18 15,110 BLOCK_SOLID_BROWN
block 19 14,59 BLOCK_ROCK
block 20 15,111 BLOCK_SOLID_BROWN
block 21 14,52 BLOCK_ROCK
block 22 11,37 BLOCK_ROCK
block 23 11,28 BLOCK_ROCK
block 24 14,67 BLOCK_ROCK
block 25 11,18 BLOCK_ROCK
block 26 11,11 BLOCK_QUESTION fireflower,visible
block 27 15,11 BLOCK_ROCK
block 28 8,63 BLOCK_ROCK
block 29 14,81 BLOCK_QUESTION coin1,hidden
block 30 8,55 BLOCK_ROCK
block 31 14,87 BLOCK_QUESTION coin1,hidden
block 32 11,4 BLOCK_ROCK
block 33 14,84 BLOCK_QUESTION coin1,hidden

# Enemies
3
14,115 bowser
13,120 axe
17,138 toad

# Warps
0

# Other
7
15,11 firestick
11,28 firestick
11,37 firestick
11,43 firestick
14,52 firestick
14,59 firestick
8,63 firestick

0 0 0 0 0 0 0 0 0 0 0 0 0 0 0 0 0 0 0 0 0 0 0 0 0 0 0 0 0 0 0 0 0 0 0 0 0 0 0 0 0 0 0 0 0 0 0 0 0 0 0 0 0 0 0 0 0 0 0 0 0 0 0 0 0 0 0 0 0 0 0 0 0 0 0 0 0 0 0 0 0 0 0 0 0 0 0 0 0 0 0 0 0 0 0 0 0 0 0 0 0 0 0 0 0 0 0 0 0 0 0 0 0 0 0 0 0 0 0 0 0 0 0 0 0 0 0 0 0 0 0 0 0 0 0 0 0 0 0 0 0 0 0
0 0 0 0 0 0 0 0 0 0 0 0 0 0 0 0 0 0 0 0 0 0 0 0 0 0 0 0 0 0 0 0 0 0 0 0 0 0 0 0 0 0 0 0 0 0 0 0 0 0 0 0 0 0 0 0 0 0 0 0 0 0 0 0 0 0 0 0 0 0 0 0 0 0 0 0 0 0 0 0 0 0 0 0 0 0 0 0 0 0 0 0 0 0 0 0 0 0 0 0 0 0 0 0 0 0 0 0 0 0 0 0 0 0 0 0 0 0 0 0 0 0 0 0 0 0 0 0 0 0 0 0 0 0 0 0 0 0 0 0 0 0 0
0 0 0 0 0 0 0 0 0 0 0 0 0 0 0 0 0 0 0 0 0 0 0 0 0 0 0 0 0 0 0 0 0 0 0 0 0 0 0 0 0 0 0 0 0 0 0 0 0 0 0 0 0 0 0 0 0 0 0 0 0 0 0 0 0 0 0 0 0 0 0 0 0 0 0 0 0 0 0 0 0 0 0 0 0 0 0 0 0 0 0 0 0 0 0 0 0 0 0 0 0 0 0 0 0 0 0 0 0 0 0 0 0 0 0 0 0 0 0 0 0 0 0 0 0 0 0 0 0 0 0 0 0 0 0 0 0 0 0 0 0 0 0
512 512 768 4096 4608 512 512 512 512 512 512 512 512 512 512 512 512 512 512 512 512 512 512 512 512 512 512 512 512 512 512 512 512 512 512 512 512 512 512 512 512 512 512 512 512 512 512 512 512 512 512 512 512 512 512 512 512 512 512 512 512 512 512 512 512 512 512 512 512 512 512 512 512 512 512 512 512 512 512 512 512 512 512 512 512 512 512 512 512 512 512 512 512 512 512 512 512 512 512 512 512 512 512 512 512 512 512 512 512 512 512 512 512 512 512 512 512 512 512 512 512 512 512 512 512 512 512 512 512 512 512 512 512 512 512 512 512 512 512 512 512 512 512
4352 4352 4608 4096 4608 4352 4352 4352 4352 4352 4352 4352 4352 4352 4352 4352 4352 4352 4352 4352 4352 4352 4352 4352 4352 4352 4352 4352 4352 4352 4352 4352 4352 4352 4352 4352 4352 4352 4352 4352 4352 4352 4352 4352 4352 4352 4352 4352 4352 4352 4352 4352 4352 4352 4352 4352 4352 4352 4352 4352 4352 4352 4352 4352 4352 4352 4352 4352 4352 4352 4352 4352 4352 4352 4352 4352 4352 4352 4352 4352 4352 4352 4352 4352 4352 4352 4352 4352 4352 4352 4352 4352 4352 4352 4352 4352 4352 4352 4352 4352 4352 4352 4352 4352 4352 4352 4352 4352 4352 4352 4352 4352 4352 4352 4352 4352 4352 4352 4352 4352 4352 4352 4352 4352 4352 4352 4352 4352 4352 4352 4352 4352 4352 4352 4352 4352 4352 4352 4352 4352 4352 4352 4352
4352 4352 4608 4096 4608 4352 4352 4352 4352 4352 4352 4352 4352 4352 4352 4352 4352 4352 4352 4352 4352 4352 4352 4352 4352 4352 4352 4352 4352 4352 4352 4352 4352 4352 4352 4352 4352 4352 4352 4352 4352 4352 4352 4352 4352 4352 4352 4352 4352 4352 4352 4352 4352 4352 4352 4352 4352 4352 4352 4352 4352 4352 4352 4352 4352 4352 4352 4352 4352 4352 4352 4352 4352 4352 4352 4352 4352 4352 4352 4352 4352 4352 4352 4352 4352 4352 4352 4352 4352 4352 4352 4352 4352 4352 4352 4352 4352 4352 4352 4352 4352 4352 4352 4352 4352 4352 4352 4352 4352 4352 4352 4352 4352 4352 4352 4352 4352 4352 4352 4352 4352 4352 4352 4352 4352 4352 4352 4352 4352 4352 4352 4352 4352 4352 4352 4352 4352 4352 4352 4352 4352 4352 4352
4352 4352 4608 4096 4608 4352 4352 4352 4352 4352 4352 4352 4352 4352 4352 4352 4352 4352 4352 4352 4352 4352 4352 4352 4352 4352 4352 4352 4352 4352 4352 4352 4352 4352 4352 4352 4352 4352 4352 4352 4352 4352 4352 4352 4352 4352 4352 4608 7936 8192 8192 8192 8192 8192 8192 8192 8192 8192 8192 8192 8192 8192 8192 8192 8192 8192 8192 8192 8192 8192 8192 8448 4096 4352 4352 4352 4352 4352 4608 7936 8192 8192 8192 8192 8192 8192 8192 8192 8192 8192 8192 8192 8192 8192 8192 8192 8192 8448 4096 4352 4352 4352 4352 4608 7936 8192 8192 8192 8192 8192 8192 8192 8192 8192 8192 8192 8192 8192 8192 8448 4096 4352 4608 7936 8192 8192 8192 8192 8192 8192 8192 8192 8192 8192 8192 8192 8192 8192 8192 8192 8192 8192 8192
4352 4352 4608 4096 4608 7936 8192 8192 8192 8192 8192 8192 8192 8192 8192 8192 8192 8448 4096 4352 4352 4352 4352 4352 4352 4352 4352 4352 4352 4352 4352 4352 4352 4352 4352 4352 4352 4352 4352 4352 4352 4352 4352 4352 4352 4352 4352 4608 0 0 0 0 0 0 7936 8192 8448 0 0 0 0 0 7936 8192 8448 0 0 0 0 0 0 0 4096 4352 4352 4352 4352 4352 4608 0 0 0 0 0 0 0 0 0 0 0 0 0 0 0 0 0 0 0 4096 4352 4352 4352 4352 4608 0 0 0 0 0 0 0 0 0 0 0 0 0 0 0 0 4096 4352 4608 0 0 0 0 0 0 0 0 0 0 0 0 0 0 0 0 0 0 0 0
4352 4352 4608 4096 4608 0 0 0 0 0 0 0 0 0 0 0 0 0 4096 4352 4352 4352 4352 4352 4352 4352 4352 4352 4352 4352 4352 4352 4352 4352 4352 4352 4352 4352 4352 4352 4352 4352 4352 4352 4352 4352 4352 4608 0 0 0 0 0 0 0 0 0 0 0 0 0 0 0 0 0 0 0 0 0 0 0 0 7936 8192 8192 8192 8192 8192 8448 0 0 0 0 0 0 0 0 0 0 0 0 0 0 0 0 0 0 0 7936 8192 8192 8192 8192 8448 0 0 0 0 0 0 0 0 0 0 0 0 0 0 0 0 4096 4352 4608 0 0 0 0 0 0 0 0 0 0 0 0 0 0 0 0 0 0 0 0
8192 8192 8448 4096 4608 0 0 0 0 0 0 0 0 0 0 0 0 0 4096 4352 4352 4352 4352 4352 4352 4352 4352 4352 4352 4352 4352 4352 4352 4352 4352 4352 4352 4352 4352 4352 4352 4352 4352 4352 4352 4352 4352 4608 0 0 0 0 0 0 0 0 0 0 0 0 0 0 0 0 0 0 0 0 0 0 0 0 0 0 0 0 0 0 0 0 0 0 0 0 0 0 0 0 0 0 0 0 0 0 0 0 0 0 0 0 0 0 0 0 0 0 0 0 0 0 0 0 0 0 0 0 0 0 0 0 7936 8192 8448 0 0 0 0 0 0 0 0 0 0 0 0 0 0 0 0 0 0 0 0
0 0 0 7936 8448 0 0 0 0 0 0 0 0 0 0 0 0 0 7936 8192 8192 8192 8192 8192 8192 8192 8192 8192 8192 8192 8192 8192 8192 8192 8192 8192 8192 8192 8192 8192 8192 8192 8192 8192 8192 8192 8192 8448 0 0 0 0 0 0 0 0 0 0 0 0 0 0 0 0 0 0 0 0 0 0 0 0 0 0 0 0 0 0 0 0 0 0 0 0 0 0 0 0 0 0 0 0 0 0 0 0 0 0 0 0 0 0 0 0 0 0 0 0 0 0 0 0 0 0 0 0 0 0 0 0 0 0 0 0 0 0 0 0 0 0 0 0 0 0 0 0 0 0 0 0 0 0 0
0 0 0 0 0 0 0 0 0 0 0 0 0 0 0 0 0 0 0 0 0 0 0 0 0 0 0 0 0 0 0 0 0 0 0 0 0 0 0 0 0 0 0 0 0 0 0 0 0 0 0 0 0 0 0 0 0 0 0 0 0 0 0 0 0 0 0 0 0 0 0 0 0 0 0 0 0 0 0 0 0 0 0 0 0 0 0 0 0 0 0 0 0 0 0 0 0 0 0 0 0 0 0 0 0 0 0 0 0 0 0 0 0 0 0 0 0 0 0 0 0 0 0 0 0 0 0 0 0 0 0 0 0 0 0 0 0 0 0 0 0 0 0
0 0 0 0 0 0 0 0 0 0 0 0 0 0 0 0 0 0 0 0 0 0 0 0 0 0 0 0 0 0 0 0 0 0 0 0 0 0 0 0 0 0 0 0 0 0 0 0 0 0 0 0 0 0 0 0 0 0 0 0 0 0 0 0 0 0 0 0 0 0 0 0 0 0 0 0 0 0 0 0 0 0 0 0 0 0 0 0 0 0 0 0 0 0 0 0 0 0 0 0 0 0 0 0 0 0 0 0 0 0 0 0 0 0 0 0 0 0 0 0 0 0 0 0 0 0 0 0 0 0 0 0 0 0 0 0 0 0 0 0 0 0 0
0 0 0 0 0 0 0 0 0 0 0 0 0 0 0 0 0 0 0 0 0 0 0 0 0 0 0 0 0 0 0 0 0 0 0 0 0 0 0 0 0 0 0 0 0 0 0 0 0 0 0 0 0 0 0 0 0 0 0 0 0 0 0 0 0 0 0 0 0 0 0 0 0 0 0 0 0 0 0 0 0 0 0 0 0 0 0 0 0 0 0 0 0 0 0 0 0 0 0 0 0 0 0 0 0 0 0 0 0 0 0 0 0 0 0 0 0 0 0 0 0 0 0 0 0 0 0 0 0 0 0 0 0 0 0 0 0 0 0 0 0 0 0
0 0 0 0 0 0 0 0 0 0 0 0 0 0 0 0 256 512 512 512 512 512 512 512 512 512 512 512 512 512 512 512 512 512 512 512 512 512 512 512 512 512 512 512 512 512 512 768 0 0 0 0 0 0 0 0 0 0 0 0 0 0 0 0 0 0 0 0 0 0 0 0 0 0 0 0 0 0 0 0 0 0 0 0 0 0 0 0 0 0 0 0 0 0 0 0 0 0 0 0 0 0 0 0 0 0 0 0 0 0 0 0 0 0 0 0 0 0 0 256 512 512 768 0 0 0 0 0 0 0 0 0 0 0 0 0 0 0 0 0 0 0 0
512 512 512 512 512 512 768 0 0 0 256 512 768 0 0 0 4096 4352 4352 4352 4352 4352 4352 4352 4352 4352 4352 4352 4352 4352 4352 4352 4352 4352 4352 4352 4352 4352 4352 4352 4352 4352 4352 4352 4352 4352 4352 4608 256 512 512 512 512 512 512 512 512 512 512 512 512 512 512 512 512 512 512 512 512 512 512 512 512 512 512 512 512 512 768 0 0 0 0 0 0 0 0 0 0 0 0 256 512 512 768 0 0 0 256 512 512 512 512 768 0 0 0 0 0 0 0 0 0 0 0 0 0 0 0 4096 4352 4352 4608 0 0 0 0 0 0 0 0 0 0 0 0 0 0 0 0 0 0 0 0
4352 4352 4352 4352 4352 4352 4608 0 0 0 4096 4352 4608 0 0 0 4096 4352 4352 4352 4352 4352 4352 4352 4352 4352 4352 4352 4352 4352 4352 4352 4352 4352 4352 4352 4352 4352 4352 4352 4352 4352 4352 4352 4352 4352 4352 4608 4096 4352 4352 4352 4352 4352 4352 4352 4352 4352 4352 4352 4352 4352 4352 4352 4352 4352 4352 4352 4352 4352 4352 4352 4352 4352 4352 4352 4352 4352 4608 0 0 0 0 0 0 0 0 0 0 0 0 4096 4352 4352 4608 0 0 0 4096 4352 4352 4352 4352 4608 0 0 0 0 0 0 0 0 0 0 0 0 0 0 0 4096 4352 4352 4608 0 0 0 0 0 0 0 0 0 0 0 0 0 0 0 0 0 0 0 0
4352 4352 4352 4352 4352 4352 4608 10752 11008 11264 4096 4352 4608 11008 11264 11520 4096 4352 4352 4352 4352 4352 4352 4352 4352 4352 4352 4352 4352 4352 4352 4352 4352 4352 4352 4352 4352 4352 4352 4352 4352 4352 4352 4352 4352 4352 4352 4608 4096 4352 4352 4352 4352 4352 4352 4352 4352 4352 4352 4352 4352 4352 4352 4352 4352 4352 4352 4352 4352 4352 4352 4352 4352 4352 4352 4352 4352 4352 4608 0 0 0 0 0 0 0 0 0 0 0 0 4096 4352 4352 4608 0 0 0 4096 4352 4352 4352 4352 4608 0 0 0 0 0 0 0 0 0 0 0 0 0 0 0 4096 4352 4352 4608 0 0 0 0 0 0 0 0 0 0 0 0 0 0 0 0 0 0 0 0
4352 4352 4352 4352 4352 4352 4608 15104 15104 15104 4096 4352 4608 15104 15104 15104 4096 4352 4352 4352 4352 4352 4352 4352 4352 4352 4352 4352 4352 4352 4352 4352 4352 4352 4352 4352 4352 4352 4352 4352 4352 4352 4352 4352 4352 4352 4352 4608 4096 4352 4352 4352 4352 4352 4352 4352 4352 4352 4352 4352 4352 4352 4352 4352 4352 4352 4352 4352 4352 4352 4352 4352 4352 4352 4352 4352 4352 4352 4608 256 512 512 512 512 512 512 512 512 512 512 768 4096 4352 4352 4608 256 512 768 4096 4352 4352 4352 4352 4608 11264 11520 10752 11008 11264 11520 10752 11008 11264 11520 10752 11008 11264 11520 10752 4096 4352 4352 4608 256 512 512 512 512 512 512 512 512 512 512 512 512 512 512 512 512 512 512 512
4352 4352 4352 4352 4352 4352 4608 15104 15104 15104 4096 4352 4608 15104 15104 15104 4096 4352 4352 4352 4352 4352 4352 4352 4352 4352 4352 4352 4352 4352 4352 4352 4352 4352 4352 4352 4352 4352 4352 4352 4352 4352 4352 4352 4352 4352 4352 4608 4096 4352 4352 4352 4352 4352 4352 4352 4352 4352 4352 4352 4352 4352 4352 4352 4352 4352 4352 4352 4352 4352 4352 4352 4352 4352 4352 4352 4352 4352 4608 4096 4352 4352 4352 4352 4352 4352 4352 4352 4352 4352 4608 4096 4352 4352 4608 4096 4352 4608 4096 4352 4352 4352 4352 4608 15104 15104 15104 15104 15104 15104 15104 15104 15104 15104 15104 15104 15104 15104 15104 4096 4352 4352 4608 4096 4352 4352 4352 4352 4352 4352 4352 4352 4352 4352 4352 4352 4352 4352 4352 4352 4352 4352 4352
